NO textures/pipes.xpm
WE textures/console.xpm
SO textures/supports_space.xpm
EA textures/wall_space.xpm

F 220,0,255
C 225,30,0

11111111111111111111111
10000000000000000000001
10000000000000000000001
10001111111111111110001
10001             10001
10001             10001
10001             10001
10001             11001
10001             10001
10001111111111111110001
10000000000010000000001
100000000000000000000N1
11111111111111111111111
